. . . . . . . . . . . . . . . . . . . . . . . . . . . .
. + - - - - + - - - - - - - + - - - - - - + - - - - + .
. | . . . . | . . . . . . . | . . . . . . | . . . . | .
. | . . . . | . . . . . . . | . . . . . . | . . . . | .
. | . . . . | . . . . . . . | . . . . . . | . . . . | .
. + - - - - + - - - - - - - + - - - - - - + - - - - + .
. | . . . . | . . . . . . . . . . . . . . | . . . . | .
. | . . . . | . . . . . . . . . . . . . . | . . . . | .
. + - - - - + - - - - - - - + - - - - - - + - - - - + .
. . . . . . | . . . . . . . | . . . . . . | . . . . . .
. . . . . . | . . . . . . . | . . . . . . | . . . . . .
. . . . . . | . . + - - - - + - - - + . . | . . . . . .
. . . . . . | . . | . . . . . . . . | . . | . . . . . .
. . . . . . | . . | . . . . . . . . | . . | . . . . . .
+ - - - - - + - - + - - - - + - - - + - - + - - - - - +
. . . . . . | . . | . . . . | . . . | . . | . . . . . .
. . . . . . | . . | . . . . | . . . | . . | . . . . . .
+ - - - - - + - - + - - - - + - - - + - - + - - - - - +
. . . . . . | . . | . . . . . . . . | . . | . . . . . .
. . . . . . | . . | . . . . . . . . | . . | . . . . . .
. . . . . . + - - + - - - - + - - - + - - + . . . . . .
. . . . . . | . . . . . . . | . . . . . . | . . . . . .
. . . . . . | . . . . . . . | . . . . . . | . . . . . .
. . . . . . + - - + - - - - + - - - + - - + . . . . . .
. . . . . . | . . | . . . . . . . . | . . | . . . . . .
. . . . . . | . . | . . . . . . . . | . . | . . . . . .
. + - - - - + . . + - - - - + - - - + . . + - - - - + .
. | . . . . . . . . . . . . | . . . . . . . . . . . | .
. | . . . . . . . . . . . . | . . . . . . . . . . . | .
. + - - - - - - - - - - - - + - - - - - - - - - - - + .
. . . . . . . . . . . . . . . . . . . . . . . . . . . .

